ア	a	a
イ	i	i
ウ	u	u͍
エ	e	e
オ	o	o
カ	ka	ka
キ	ki	ki
ク	ku	ku͍
ケ	ke	ke
コ	ko	ko
キャ	kya	kʲa
キュ	kyu	kʲu͍
キョ	kyo	kʲo
サ	sa	sa
シ	shi	ɕi
ス	su	su͍
セ	se	se
ソ	so	so
シャ	sha	ɕa
シュ	shu	ɕu͍
ショ	sho	ɕo
タ	ta	ta
チ	chi	t͡ɕi
ツ	tsu	t͡su͍
テ	te	te
ト	to	to
チャ	cha	t͡ɕa
チュ	chu	t͡ɕu͍
チョ	cho	t͡ɕo
ナ	na	na
ニ	ni	nʲi
ヌ	nu	nu͍
ネ	ne	ne
ノ	no	no
ニャ	nya	ɲa
ニュ	nyu	ɲu͍
ニョ	nyo	ɲo
ハ	ha	ha
ヒ	hi	çi
フ	fu	ɸu͍
ヘ	he	he
ホ	ho	ho
ヒャ	hya	ça
ヒュ	hyu	çu͍
ヒョ	hyo	ço
マ	ma	ma
ミ	mi	mi
ム	mu	mu͍
メ	me	me
モ	mo	mo
ミャ	mya	mʲa
ミュ	myu	mʲu͍
ミョ	myo	mʲo
ヤ	ya	ja
ユ	yu	ju͍
ヨ	yo	jo
ラ	ra	ɽa
リ	ri	ɽi
ル	ru	ɽu͍
レ	re	ɽe
ロ	ro	ɽo
リャ	rya	ɽʲa
リュ	ryu	ɽʲu͍
リョ	ryo	ɽʲo
ワ	wa	wa
ヲ	o/wo	ʷo
ン	n	n
ガ	ga	ɡa
ギ	gi	ɡi
グ	gu	ɡu͍
ゲ	ge	ɡe
ゴ	go	ɡo
ギャ	gya	ɡʲa
ギュ	gyu	ɡʲu͍
ギョ	gyo	ɡʲo
ザ	za	za
ジ	ji	d͡ʑi
ズ	zu	zu͍
ゼ	ze	ze
ゾ	zo	zo
ジャ	ja	d͡ʑa
ジュ	ju	d͡ʑu͍
ジョ	jo	d͡ʑo
ダ	da	da
ヂ	ji	d͡ʑi
ヅ	zu	zu͍
デ	de	de
ド	do	do
ヂャ	ja	d͡ʑa
ヂュ	ju	d͡ʑu͍
ヂョ	jo	d͡ʑo
バ	ba	ba
ビ	bi	bi
ブ	bu	bu͍
ベ	be	be
ボ	bo	bo
ビャ	bya	bʲa
ビュ	byu	bʲu͍
ビョ	byo	bʲo
パ	pa	pa
ピ	pi	pi
プ	pu	pu͍
ペ	pe	pe
ポ	po	po
ピャ	pya	pʲa
ピュ	pyu	pʲu͍
ピョ	pyo	pʲo
イィ	yi	ji
イェ	ye	je
ウァ	wa	wa
ウィ	wi	wi
ウゥ	wu	wu͍
ウェ	we	we
ウォ	wo	wo
ウュ	wyu	wʲu͍
ヴァ	va	va
ヴィ	vi	vi
ヴ	vu	vu͍
ヴェ	ve	ve
ヴォ	vo	vo
ヴャ	vya	vʲa
ヴュ	vyu	vʲu͍
ヴョ	vyo	vʲo
ヴィェ	vye	vʲe
キェ	kye	kʲe
ギェ	gye	ɡʲe
クァ	kwa	kʷa
クィ	kwi	kʷi
クェ	kwe	kʷe
クォ	kwo	kʷo
グァ	gwa	ɡʷa
グィ	gwi	ɡʷi
グェ	gwe	ɡʷe
グォ	gwo	ɡʷo
シェ	she	ɕe
ジェ	je	d͡ʑe
スィ	si	si
ズィ	zi	zi
チェ	che	t͡ɕe
ツァ	tsa	t͡sa
ツィ	tsi	t͡si
ツェ	tse	t͡se
ツォ	tso	t͡so
ツュ	tsyu	t͡sʲu͍
ティ	ti	ti
トゥ	tu	tu͍
テュ	tyu	tʲu͍
ディ	di	di
ドゥ	du	du͍
デュ	dyu	dʲu͍
ニェ	nye	ɲe
ヒェ	hye	çe
ビェ	bye	bʲe
ピェ	pye	pʲe
ファ	fa	ɸa
フィ	fi	ɸi
フェ	fe	ɸe
フォ	fo	ɸo
フャ	fya	ɸʲa
フュ	fyu	ɸʲu͍
フョ	fyo	ɸʲo
フィェ	fye	ɸʲe
ホゥ	hu	hu͍
ミェ	mye	mʲe
リェ	rye	ɽʲe