一	イチ	one	eins
丨	ぼう、たてぼう	rod, stick, line	Vertikalstrich
丶	てん	dot	Tropfstrich
丿	の、はらいぼう	slash, kana-no	Schrägstrich
乙乚	オツつりばりおつにょう	fish hook	Angelhaken, Zweiter
亅	はねぼう、ケツ、かぎ	feathered stick barb	Vertikalstrich mit Haken
二	ニ	two	zwei
亠	けいさんかんむり、なべぶたけさんかんむり	lid	Deckel, Kopf
人亻𠆢	ひとにんべんひとがしら、ひとやね	person	Mensch, jeder, jemand, alle, Persönlichkeit, Charakter
儿	にんにょう、ひとあし	human legs	Beine, Kind, Jugendlicher, Sohn
入	いるいりがしらいりやねニュウ	enter	eintreten, betreten, Einkommen, übereinstimmen mit
八丷	ハチはちがしら	eight	acht
冂	けい·、まき·、どう·、えん·がまえ	display case	umfassen, Wildnis, freies/offenes Land
冖	わ·、べき·かんむり	wa-shaped crown	bedecken
冫	にすい	water drops	Eis
几	つくえきにょうつくえきにょうかぜかんむりかぜがまえ	table table enclosure	Tischchen
凵	かんにょう、うけばこ	open box enclosure	Behälter, geöffneter Mund
刀刂	かたなりっとう	sword	Messer, Schwert, Hiebwaffe, Säbel
力	ちから	strong	Kraft, Stärke, Fähigkeit
勹	つつみがまえ	wrapping	einwickeln, umarmen
匕	ヒ、さじ、さじのひ	spoon	Löffel
匚	はこがまえ	sideways box	Kasten
匸	かくしがまえ	hiding enclosure 	verstecken, runde Schachtel
十	ジュウ	ten, cross	zehn, völlig, vollständig
卜	ボク、ぼくのと、うらない	divining rod	Orakel
卩㔾	ふしづくり、わりふまげわりふ	seal	Siegel
厂	がんだれ	cliff	Abhang
厶	む	myself	privat
又	また	furthermore	wieder, noch, Hand
口⼝	くちくちへん	mouth	Mund, Öffnung, Eingang, Mündung
囗	くにがまえ	box	Begrenzung, Umzäunung
土⼟	つちつちへん	earth	Erde, Boden, Land, unkultiviert
士⼠	さむらいさむらいかんむり	samurai	Gelehrter, Intellektueller, Junggeselle, Soldat
夂	ふゆがしら、ち·、のまた·かんむり	winter	schlendern, Winter
夊	すいにょう、なつあし	descend	überholen
夕	ゆう、ゆうべ、タ	evening	Abend, Sonnenuntergang
大⼤	ダイだいかんむり、だいかしら	big	groß, riesig, gewaltig, Alter, sehr
女⼥	おんなおんなへん	woman	Frau, weiblich
子⼦	こ、こどもこへん、こどもへん	child	Kind, Meister, Samen
宀	うかんむり	crown	Dach
寸	スン	glue	Daumen, Zoll
小⺍⺌	ショウ、ちいさいしょうがしらなおがしら	little	klein, geringfügig, unbedeutend, jung
尢尣	だいのまげあしまげあし、おうにょう、オウ	crooked-big	lahm, gebrochenes Bein
尸⼫	しかばね、かばねしかばねかんむり、かばねだれ	flag	Leichnam, Flagge
屮	テツ、くさのめ、めばえ	old grass	Spross, Keim
山⼭	やまやまへん	mountain	Berg, Gebirge
巛⼮川	まがりかわさんぽがわかわ	crooked river	Strom, Fluss
工⼯	コウ、たくみたくみへん	craft	Arbeit
己已巳	コ、キ、おのれ、イ、すでに、シ、み	snake	selbst, persönlich, eigen
巾⼱	はばはばへん、きんへん	cloth	Tuch, Schal
干	カン、いちじゅう、ほす	dry	trocken, Schild (Waffe)
幺	ヨウ、いとがしら	short thread	jung, gering, klein, Faden
广	まだれ	dotted cliff	Schrägdach
廴	えんにょう、えんにゅう、いんにょう	long stride	bewegen, marschieren
廾	キョウ、こまぬき、にじゅうあし	twenty	gefaltete Hände, zwanzig
弋	ヨク、しきがまえ	ceremony	Jagdpfeil, Wurfspieß, Haken
弓	ゆみ、ゆみへん	bow	Bogen (Waffe oder Musik)
彐彑⺕	けいがしらけいがしらいのこがしら	pig head	Schweinskopf, Schweinerüssel
彡	さんづくり、けかざり、かみかざり	tuft	Bart, Haare
彳	ぎょうにんべん	going man	Schritt, Spazieren gehen
心忄⺗	こころりっしんべんしたごころ	heart	Herz, Gefühl
戈⼽	ほこ、たすきほこづくり、ほこがまえかのほこ	halberd	Speer, Hellebarde, Hiebaxt
戸	と、とかんむり、とだれ、とびらのと	door	Waffe, Tür, Haus, Familie
手扌	ててへん	hand	Hand, in der Hand halten
支	しにょう、えだにょう、じゅうまた	branch	Zweig, stützen, aufrichten, Abzweigung
攴攵	ぼくづくり、のぶん、ぼくにょう、しぶん、とまた	folding chair	schlagen, Peitsche, Klappstuhl
文	ブン、ぶんにょう、ふみつくり	sentence	Kultur, Schrift(zeichen), Sprache
斗	とます、ます、ト	dipper	Scheffel, Dou (Hohlmaß)
斤	おの、おのづくり、キン	axe	Axt, Pfund
方⽅	ホウほうへん、かたへん	direction	Himmelsrichtung, Viereck
无旡	なし、すでのつくり、むにょう、ブ	crooked heaven	nicht, keiner, ohne
日⽇	ひ、にちひへん、にちへん	sun, day	Sonne, Tag
曰	ひらび、いわく	say	sagen, sprechen
月	つきつきへんにくづきふなづき	moon, month	Mond, Monat
木⽊	ききへん	tree	Baum, Holz
欠	あくび、かける	gap	mangeln, gähnen
止⽌	とめるとめへん	stop	anhalten, aufhören, stoppen
歹歺	ガツ、がつ·、かば·、いちた·へんしにがまえ	death	zersetzen, schlecht
殳	ほこづくり、ほこ、るまた	windy again	Hellebarde, Lanze
毋母	なかれ、はは、ははのかん	mother	Mutter, nicht
比	ヒ、ならびひ、くらべる	race	vergleichen, sich messen mit
毛	け	wool	Haar, Borste
氏	うじ	clan	Familie, Sippe
气	きがまえ	spirit	Atem, Luft, Gas, Dampf
水氵氺	みずさんずいしたみず	water	Wasser, Gewässer
火⽕灬	ひひへんれっか、れんが	fire	Feuer
爪⺤⽖	つめつめかんむりそうにょう	claw	Klaue, Kralle
父	ちち	father	Vater
爻	コウ	double X	mischen, durchkreuzen, knüpfen
爿⺦	ショウしょうへん	left-side kata	gespaltenes Holz (steht immer links)
片⽚	かたかたへん	one-sided leaf sheet	gespaltenes Holz, Scheibe (immer links)
牙⽛	きばきばへん	fang	Eckzahn
牛牜	うしうしへん	cow	Rind; 2. Erdzweig 
犬⺨	いぬけものへん	dog	Hund
玄	ゲン	mysterious	dunkel
玉⺩王	たまたまへん、おうへんたま、おう	jewel	Juwel, Kugel, Jade
瓜	うり	melon	Melone, Kürbis, Gurke
瓦	かわら	tile	Ziegel
甘	あまい、カン	sweet	süß, wohlschmeckend
生	セイ、ショウ、いきる、うまれる	life	geboren werden, leben, erzeugen
用	ヨウ、もちいる	use	gebrauchen, benutzen, nötig haben
田	た、たへん	rice field	Reisfeld
疋⺪	ヒキひきへん	head count	Rolle Kleiderstoff, Stoffballen
疒	やまいだれ	sickness	Krankheit
癶	はつがしら	dotted tent	gespreizte Beine, zwei Hände oberhalb
白⽩	しろしろへん	white	weiß
皮	けがわ、ひのかわ	hide	Haut, Schale, Pelz
皿	さら	dish	Schüssel, Teller
目⽬⺫	めめへんよこめ	eye	Auge
矛⽭	ほこほこへん	halberd	Hellebarde, Speer, Lanze
矢⽮	ややへん	arrow	Pfeil
石⽯	いしいしへん	stone	Stein
示礻	しめすしめすへん、ねへん	show	zeigen, Vorfahren, verehren
禸	ぐうのあし	track, footprint	Fußstapfen, Spur
禾⽲	いね、のぎいねへん、のぎへん	two branch tree	Getreide
穴⽳㓁	あなあなかんむりあな	cave, slit, hole	Höhle
立⽴	たつたつへん	stand	stehen, aufrichten
竹⺮	たけたけかんむり	bamboo	Bambus
米⽶	こめこめへん	rice	Reis
糸糹	いといとへん	thread	Seide
缶⽸	ほとぎ、フ、カンほとぎへん	can	Krug, Amphore
网罒	あみめあみがしら、よんがしら	net crown	Netz
羊⽺	ひつじひつじへん	sheep	Schaf, Ziege; 8. Erdzweig 
羽	はね	feathers	Vogelfeder
老耂	おいるおいかんむり、おいがしら	old man	alt
而	しこうして、しかして	rake	und dabei, und, aber
耒⽾	らいすきすきへん	three branch tree	Pflug, Egge
耳⽿	みみみみへん	ear	Ohr
聿	イツ、ふでづくり	writing brush	Schreibpinsel
肉⺼	ニクにくづき	meat	Fleisch
臣	シン	retainer	Diener, Minister, Untertan, Beamter
自	ジ、みずから	oneself	selbst
至⾄	いたるいたるへん	climax	ankommen, erreichen
臼	うす	mortar	Mörser
舌⾆	したしたへん	tongue	Zunge
舛	まいあし、ます	dancing	gegensätzlich, irren, nebeneinander liegen
舟⾈	ふねふねへん	ship	Schiff, Boot, Kahn
艮	コン、ゴン、こん·、ごん·、ね·づくり、うしとら	good	Grenze
色	いろ	color	Farbe, weibliche Schönheit
艸艹	くさくさかんむり、そうこう	grass	Gras 
虍	とらかんむり、とらがしら	tiger crown	Tiger
虫⾍	むしむしへん	bug	Wurm, Insekt
血	ち	blood	Blut
行⾏	ギョウ、ゆきゆきがまえ、ぎょうがまえ	journey	gehen, machen, tun
衣衤	ころもころもへん	clothing	Kleidung
襾覀	にしおおいかんむり	west	bedecken, Westen
見	みる	see	sehen
角⾓	つのつのへん	corner	Horn, Ecke
言訁	ことば、ごんべん、ゲン	say	sprechen, Wort
谷⾕	たにたにへん	valley	Tal, Schlucht, Getreide
豆⾖	まめまめへん	bean	Bohne
豕⾗	いのこ、ぶたいのこへん	pig	Schwein
豸	むじなへん	badger	Reptil, Katze, kleines haariges Tier
貝⾙	かいかいへん、こがい	shellfish	Muschel- oder Schneckengeld, Kauri
赤⾚	あかあかへん	red	zinnoberrot, nackt
走⾛	はしるそうにょう	run	laufen, fortgehen
足⻊	あしあしへん	foot	Fuß
身⾝	みみへん	station in life	Körper, Rumpf
車⾞	くるまくるまへん	car	Wagen, Rad, Fahrzeug
辛	シン、からい	spicy hot	bitter, scharf, beißend, hart, mühsam
辰	しんのたつ	sign of the dragon	7-9 Uhr vormittags, Morgen, 5. Erdzweig
辵⻌	しんにょう	road, walk	vorwärts gehen
邑⻏	むら、おおざと	right village	Gemeinde, Dorf
酉⾣	ひよみのとりとりへん、さけのとり	sake	Weinkrug, Alkohol
釆⾤	のごめのごめへん	dice	trennen, unterscheiden, auswählen
里⾥	さとさとへん	village	Ri (~4 km), Dorf
金釒	かねかねへん	metal, gold	Metall, Gold
長	ながい	long, grow	lang, älter, wachsen
門	モン、もんがまえ、かどがまえ	gate	Tor, Tür
阜⻖	おかこざとへん	left village, mound, dam	Hügel, Damm
隶	れいづくり	slave, capture	fangen, untergeordnet sein
隹	ふるとり	old bird	alter Vogel
雨⻗	あめあめかんむり	rain	Regen
青	あお	blue green	blaugrün, jung
非	あらず、ヒ	injustice	falsch, nicht, Fehler
面	メン	face	Gesicht
革	かわへん、つくりがわ	leather pelt	ungegerbtes Leder, Haut, verändern
韋	なめしがわ	tanned leather	gegerbtes Leder
韭	にら	leek	Lauch
音⾳	おとおとへん	sound	Laut, Ton
頁	おおがい	page	Kopf
風	かぜ	wind	Wind
飛	とぶ	flying	fliegen
食飠	ショクしょくへん	food	Essen, Futter
首	くび	neck	Kopf, Haupt
香	かおり、カ	smell	Duft
馬⾺	うまうまへん	horse	Pferd; 7. Erdzweig 
骨⾻	ほねほねへん	bone	Knochen
高	たかい	high	hoch
髟	かみかんむり、かみがしら	long hair	lange Haare
鬥	とうがまえ、たたかいがまえ	broken gate	kämpfen
鬯	チョウ、においざけ	fragrant herbs	duftende Kräuter
鬲	かなえ、レキ	tripod	Dreifuß
鬼⿁	おにきにょう	devil	Gespenst, Dämon
魚⿂	うお、さかなうおへん	fish	Fisch
鳥⿃	とりとりへん	bird	Vogel
鹵	しお、ロ	salt	Salz, Lauge
鹿	しか	deer	Hirsch, Reh
麦麥	むぎ、ばくにょう	wheat	Weizen, Gerste
麻⿇	あさあさかんむり	flax	Hanf, Flachs, Jute
黄	き	yellow	gelb
黍	きび	millet	Hirse
黒	くろ	black	schwarz
黹	ぬいとり、ふつへん、チ	sewing	sticken, Näharbeit
黽	べんあし、かえる、ベン	green frog	Frosch, Amphibie
鼎	かなえ、テイ	three legged kettle	dreibeiniger Kessel, Dreifuß
鼓	つづみ	drum beat	Trommel
鼠	ねずみ、ねずみへん	mouse	Ratte, Maus; 1. Erdzweig 
鼻⿐	はなはなへん	nose	Nase
斉齊	セイ	equal	gleich, ordnen, gleichmäßig
歯⻭齒	ははへん	tooth	Backenzahn, Zahn
竜龍	リュウ	dragon	Drache
亀龜	かめ	turtle	Schildkröte
龠	ヤク、ふえ	flute	Flöte
